W: Monowhite/Mono-White
U: Monoblue/Mono-Blue
B: Monoblack/Mono-Black 
R: Monored/Mono-Red
G: Monogreen/Mono-Green
WU: Azorius
WB: Orzhov
WR: Boros
WG: Selesnya
UB: Dimir
UR: Izzet
UG: Simic
BR: Rakdos
BG: Golgari
RG: Gruul
GWU: Bant
WUB: Esper
UBR: Grixis
BRG: Jund
RGW: Naya
WBG: Abzan/Indatha/Necra
URW: Jeskai/Raka/Raugrin
BUG: Sultai/Ana/Bug/Zagoth
RWB: Mardu/Dega/Savai
URG: Temur/Ceta/Rug/Ketria
UBRG: Chaos/Glint/Glint-Eye/Non-White
BRGW: Aggression/Dune/Dune-Brood/Non-Blue
RGWU: Altruism/Ink/Ink-Treader/Non-Black
GWUB: Growth/Witch/Witch-Maw/Non-Red
WUBR: Artifice/Yore/Yore-Tiller/Non-Green
WUBRG: Domain/Five-Color
C: Colorless/Monobrown/Mono-Brown